1111111111111111
11CC000000000011
1100000000000011
11000000E0000011
1100000000000011
1100000000000011
11000000000PC011
1111111111111111