11111111111111111111111111
1P1E1C100C01C0CCC000000001
10100010110111111111111101
101011101001000CCC00000001
1010100C101101111111111111
1C10101110010000CCC0000001
10001C11110111111110111111
1010001000C00C000CCC000001
11111111111111111111111111