1111111111111111111111111111111111111111
1111111111111111111111110011001101111111
1111111111111111111111111010001001111111
1111111111111110000000001000010001111111
11111111111111100000C0001000000011111111
1111111110000001111111110000000111111111
1111111101100111111111111100001111111111
1111110011001111111111111111001111111111
1111101110111111111111111111110111111111
1111011101111111111111111111110111111111
1100011100000111111111111111111011111111
1100000001111011111111111111111C11111111
110C111001111001111111000111111001111111
1101111011111101111110000011111101111111
1011111011111001111100111001111100111111
1011111001110000011001101100111101100111
1011110010000011111001111101111001100111
1001110010111111101110111011000101100111
1001110001100111010001000110010111110011
1100110011111111111100011110010111110011
1110000111111111111111101110011111110011
1110011111111111111111001100111111111001
111P011111111111111110011000111111111001
1110011111111111111100C00000111111111001
1111011111111111111110000100111111111001
1111101111111111111111111100111111111001
1111110011111111110011111100111111111001
1111101100111111000111111111111111111001
1111101111000000111111111111111111110011
1111011111111111111111111111111111000111
111001111111111111111111111111100E011111
1110111111111111111111111111111000111111
1100111111111111111111111111111110111111
1100111111111111111111111111111110111111
1111111111111111111111111111111111111111