1111111111111111
11CC000000N00011
11N0000000000011
11000000E0000011
110000NN00000011
1100000000000011
110000N0000PC011
1111111111111111