111111111111111111111111111111111
10P000000000000000000000000000001
101111010C1011110100001000C111101
1010010100101E0001000010000100101
101111011110111101000010000111101
101C00010010100001C00010000100101
101000010010111101111011110100101
100000000000000000000000000000001
111111111111111111111111111111111