111111111111111111111111111111111
1P111101001011110100001000C111101
101001010010100001000010000100101
101111011110111101000010000111101
101C00010010100001C00010000100101
101000010010111101111011110100101
100000000000000000000000000000001
101111010C1011110100001000C111101
101001010010100001000010000100101
101111011110111101000010000111101
101C000100101E0001C00010000100101
101000010010111101111011110100101
111111111111111111111111111111111